1`10`2`2;
2`10`2`2;
3`10`2`2;
4`10`2`2;
5`10`2`2;
6`10`2`2;
7`10`2`2;
8`10`2`2;
9`10`2`2;
10`10`2`2;