1`4`2`2;
2`6`2`2;
3`8`2`2;
4`14`2`2;
5`20`2`2;
6`26`2`2;
7`32`2`2;
8`38`2`2;
9`44`2`2;
10`50`2`2;